111111111111111111
10000000000C000001
100000C00000000001
100CP0E00000000C01
111111111111111111