111111111111111111
10000000000C000001
100000000000111111
1P0000E00000111C11
111111111111111111