111111111111111111111111111111111
100000000C0V0V0V0V0V0V0V0V0V0V0V1
1H00000000000000000000000V0000V01
1000P0E00C00V0V0V0V0VCV0VVV0VCV01
1H00000000000000000000000V0000001
1H00000000000000000000000V0000001
1H0000000000000000000000000000001
1H00000000000000000000000V0000001
1H00000000000000000000000V0000001
1H0000000000000000000000000000001
1H00000000000000000000000V0000001
1H00000000000000000000000V0000C01
1H00000000000000000000000V0000001
1H0000000000000000000000000000001
1H00000000000000000000000V0000001
1H00000000000000000000000V0000001
111111111111111111111111111111111