111111111111111111111111111111111
100000000C00000000000000000000001
1H0000000000000000V00000000000001
1000P0E00C00000000000C000C000C001
111111111111111111111111111111111