111111111111111111111111111111111
100000000C0V0V0V0V0V0V0V0V0V0V0V1
100000000000000000000000000000001
1H00000000000000000000000V0000V01
100000000000000000000000000000001
1000P0E00C00V0V0V0V0VCV0VCV0VCV01
111111111111111111111111111111111