111111111111111111111111111111111
1000000000000000000000000000000C1
1H0000000000000000000000000000001
1H0000E00000000000000000000000001
1H0000000000000000000000000000001
1H0000000000000000000000000000001
1H0000000000000000000000000000001
1H0000000000000000000000000000001
1H0000000000000000000000000000001
1H0000000000000000000000000000001
1H0000000000000000000000000000001
1H0000000000000000000000000000001
1H0000000000000000000000000000001
1H0000000000000000000000000000001
1H0000000000000000000000000000001
1PVVVVVVVVVVVVVVVVVVVVVVVVVVVVV01
111111111111111111111111111111111