11111111111111111111111111111111
10000000000000000000000000000001
100CCCCC0000C000C0000CCCCC000001
100C000C00000C0C00000C000C000001
100C000C000000C000000C000C000001
100CCCCC000000C000000CCCCC000001
100C000C000000C000000C000C000001
100C000C000000C000000C000C000001
100C000C000000P000000C000C000001
100000000000000000000000000000E1
11111111111111111111111111111111