111111111111111111
10000000000C000001
100000C00000000001
100CP0E0000000CC01
111111111111111111