1111111111111111111111111111111111111
10000000000C0000000001000010000100001
100000C000000000000001000010000100001
100000C000000000000001000010000100001
100000C000000000000001000010000100001
100000C000000000000000000000000000001
100000C000000000000001000010000100001
100000C000000000000001000010000100001
100000C000000000000001000010000100001
100CP0E0000000CC00CC010CC010CC010CC01
1111111111111111111111111111111111111