11111111111111111111111111111111
10000000000000C00000000000C00001
1H0000000000V0000V000000V0000V01
1000P0E00C00000000000C00000000C1
11111111111111111111111111111111